##########
S...K....#
#..##..T.#
#..B.KG..#
#....O...E
##########
