################
S.........K....#
#..####.####...#
#.K#..K.#......#
#..#....#......#
#..#....#..T...#
#..######......#
#..........B...#
#...G......O...#
#..########....E
################
