################
S..............#
#..####K####...#
#..#....#K.....#
#..#....#...T..#
#K.#....#......#
#..######......#
#..........B...#
#......G...O...#
#..########....E
################
